1,1,1,X,1,1,2,3,X,1,2,X,3,3,X
X,4,4,3,2,1,X,X,3,3,4,X,6,X,X
X,X,X,X,3,2,2,3,X,3,X,X,X,X,X
X,X,X,X,X,2,1,2,1,4,X,6,6,X,X
4,6,X,5,4,4,X,2,1,3,X,5,X,X,X
X,X,3,2,X,X,5,X,2,2,X,6,X,7,X
4,X,3,2,4,X,5,X,4,2,3,X,X,6,X
3,X,3,3,X,4,4,X,3,X,2,3,X,X,3
X,5,X,5,X,X,3,1,2,1,1,2,3,5,X
X,X,4,X,X,X,3,1,1,-,-,1,X,5,X
3,4,X,5,X,3,3,X,3,1,-,1,3,X,X
X,4,4,X,4,2,2,X,X,1,1,1,4,X,4
X,6,X,X,X,1,2,3,4,2,2,X,5,X,3
X,X,X,5,4,3,4,X,4,X,4,3,X,X,2
2,3,3,X,2,X,X,X,4,X,3,X,3,2,1