-,1,X,1,-
-,1,1,2,1
-,-,-,1,X
-,-,-,1,1
1,1,1,1,1
1,X,1,1,X
1,2,2,3,2
-,1,X,2,X
-,1,1,2,1