-,-,1,2,X,1,-,-,-,-
1,2,3,X,2,1,-,-,-,-
3,X,X,3,2,1,1,1,-,-
X,X,5,X,2,1,X,1,-,-
4,4,4,X,2,1,1,1,-,- 
X,X,4,2,2,-,-,1,1,1
3,X,3,X,2,1,1,1,X,1
1,2,3,2,2,X,1,1,1,1
-,2,X,2,2,2,2,1,1,1
-,2,X,3,2,X,1,1,X,1
1,2,3,X,3,2,2,1,1,1
1,X,2,1,2,X,1,-,-,-